##########
#........#
#.######.#
#........#
#........#
#...##...#
#........#
#.######.#
#........#
##########