###############
#......#......#
#......#......#
#......#......#
#.............#
#.............#
############..#
#.............#
#.............#
###############
I 8 1 0
I 9 1 1
I 10 1 2